111111111111
101000000001
101100000011
100100000101
100000001101
100100000001
100100000001
100100001001
100000001001
100000001111
100000000001
111111111111