111111111
101000001
101100001
100100001
100000001
100100001
100100001
100100001
111111111